na                  	on                  	on                  	na
od                  	from                	from                	od
za                  	for                 	for                 	za
da                  	yes                 	yes                 	da
kako                	how                 	how                 	kako
ne                  	no                  	no                  	ne
bil                 	was                 	was                 	bil
do                  	to                  	to                  	do
po                  	after               	after               	po
del                 	part                	part                	del
eden                	one                 	one                 	eden
isto                	the same            	the same            	isto
samo                	only                	only                	samo
vek                 	century             	century             	vek
pred                	before              	before              	pred
pod                 	under               	under               	pod
broj                	number              	number              	broj
dve                 	two                 	two                 	dve
pri                 	at                  	at                  	pri
predmet             	object              	object              	predmet
tri                 	three               	three               	tri
dva                 	two                 	two                 	dva
nad                 	above               	above               	nad
često               	often               	often               	često
primer              	example             	example             	primer
bi                  	would               	would               	bi
sistem              	system              	system              	sistem
način               	way                 	way                 	način
život               	life                	life                	život
ime                 	name                	name                	ime
grupa               	group               	group               	grupa
forma               	form                	form                	forma
voda                	water               	water               	voda
vojna               	war                 	war                 	vojna
sezona              	season              	season              	sezona
rezultat            	result              	result              	rezultat
deca                	children            	children            	deca
mora                	must                	must                	mora
maj                 	may                 	may                 	maj
nivo                	level               	level               	nivo
razvoj              	development         	development         	razvoj
avgust              	august              	august              	avgust
si                  	you are             	you are             	si
odnos               	relationship        	relationship        	odnos
energija            	energy              	energy              	energija
album               	album               	album               	album
mali                	small               	small               	mali
april               	april               	april               	april
površina            	surface             	surface             	površina
dobro               	good                	good                	dobro
sin                 	son                 	son                 	sin
film                	movie               	movie               	film
drug                	another             	another             	drug
svet                	world               	world               	svet
slučaj              	case                	case                	slučaj
kariera             	career              	career              	kariera
majka               	mother              	mother              	majka
polovina            	half                	half                	polovina
muzika              	music               	music               	muzika
smrt                	death               	death               	smrt
vrednost            	value               	value               	vrednost
hrana               	food                	food                	hrana
šest                	six                 	six                 	šest
dolžina             	length              	length              	dolžina
proizvodstvo        	production          	production          	proizvodstvo
stil                	style               	style               	stil
država              	country             	country             	država
visočina            	height              	height              	visočina
prvenstvo           	championship        	championship        	prvenstvo
značenje            	meaning             	meaning             	značenje
pravo               	right               	right               	pravo
prostor             	space               	space               	prostor
mala                	small               	small               	mala
namesto             	instead             	instead             	namesto
istorija            	history             	history             	istorija
proces              	process             	process             	proces
točka               	point               	point               	točka
linija              	line                	line                	linija
roden               	born                	born                	roden
tim                 	team                	team                	tim
politika            	politics            	politics            	politika
vojska              	army                	army                	vojska
kultura             	culture             	culture             	kultura
vlada               	government          	government          	vlada
uspeh               	success             	success             	uspeh
kontrola            	control             	control             	kontrola
pobeda              	victory             	victory             	pobeda
nova                	new                 	new                 	nova
red                 	order               	order               	red
republika           	republic            	republic            	republika
teorija             	theory              	theory              	teorija
mal                 	small               	small               	mal
organizacija        	organization        	organization        	organizacija
brat                	brother             	brother             	brat
dom                 	home                	home                	dom
faza                	phase               	phase               	faza
umetnost            	art                 	art                 	umetnost
pozicija            	position            	position            	pozicija
izbran              	selected            	selected            	izbran
funkcija            	function            	function            	funkcija
model               	model               	model               	model
dosta               	enough              	enough              	dosta
serija              	series              	series              	serija
tip                 	type                	type                	tip
klub                	club                	club                	klub
sela                	villages            	villages            	sela
mreža               	network             	network             	mreža
zavisnost           	addiction           	addiction           	zavisnost
etapa               	stage               	stage               	etapa
zad                 	behind              	behind              	zad
region              	region              	region              	region
struktura           	structure           	structure           	struktura
armija              	army                	army                	armija
ekonomski           	economic            	economic            	ekonomski
borba               	fight               	fight               	borba
direktno            	directly            	directly            	direktno
slika               	picture             	picture             	slika
industrija          	industry            	industry            	industrija
možno               	possible            	possible            	možno
naselba             	settlement          	settlement          	naselba
deset               	ten                 	ten                 	deset
rok                 	deadline            	deadline            	rok
aktivnost           	activity            	activity            	aktivnost
napad               	attack              	attack              	napad
temperatura         	temperature         	temperature         	temperatura
banka               	bank                	bank                	banka
plan                	plan                	plan                	plan
doma                	at home             	at home             	doma
svoj                	own                 	own                 	svoj
brak                	marriage            	marriage            	brak
kamen               	stone               	stone               	kamen
klasa               	class               	class               	klasa
visok               	tall                	tall                	visok
interes             	interest            	interest            	interes
efekt               	effect              	effect              	efekt
vidi                	see                 	see                 	vidi
pismo               	a letter            	a letter            	pismo
mera                	measure             	measure             	mera
objaven             	published           	published           	objaven
sostav              	composition         	composition         	sostav
rast                	growth              	growth              	rast
sledi               	follows             	follows             	sledi
stanica             	station             	station             	stanica
mesec               	month               	month               	mesec
muzej               	museum              	museum              	muzej
drvo                	tree                	tree                	drvo
tradicija           	tradition           	tradition           	tradicija
dobra               	good                	good                	dobra
služba              	service             	service             	služba
sloj                	layer               	layer               	sloj
učestvo             	participation       	participation       	učestvo
karakter            	character           	character           	karakter
literatura          	literature          	literature          	literatura
jug                 	south               	south               	jug
visina              	height              	height              	visina
kompanija           	company             	company             	kompanija
znak                	sign                	sign                	znak
krug                	circle              	circle              	krug
prijatel            	a friend            	a friend            	prijatel
sestra              	sister              	sister              	sestra
sud                 	court               	court               	sud
evropski            	european            	european            	evropski
priroda             	nature              	nature              	priroda
analiza             	analysis            	analysis            	analiza
čelo                	forehead            	forehead            	čelo
glas                	voice               	voice               	glas
titula              	title               	title               	titula
edinica             	unit                	unit                	edinica
izgled              	appearance          	appearance          	izgled
nauka               	science             	science             	nauka
roman               	a novel             	a novel             	roman
široko              	wide                	wide                	široko
bela                	white               	white               	bela
devet               	nine                	nine                	devet
važen               	important           	important           	važen
tekst               	text                	text                	tekst
lik                 	character           	character           	lik
cela                	whole               	whole               	cela
granica             	border              	border              	granica
zatvor              	prison              	prison              	zatvor
arhitektura         	architecture        	architecture        	arhitektura
poezija             	poetry              	poetry              	poezija
osnovan             	established         	established         	osnovan
akademija           	academy             	academy             	akademija
poseben             	special             	special             	poseben
turneja             	tour                	tour                	turneja
devojka             	a girl              	a girl              	devojka
sektor              	sector              	sector              	sektor
ženski              	female              	female              	ženski
mir                 	peace               	peace               	mir
učenje              	learning            	learning            	učenje
zona                	zone                	zone                	zona
vodač               	leader              	leader              	vodač
gradba              	construction        	construction        	gradba
položba             	position            	position            	položba
dizajn              	design              	design              	dizajn
težina              	weight              	weight              	težina
primena             	application         	application         	primena
simbol              	symbol              	symbol              	simbol
širok               	wide                	wide                	širok
edinstven           	unique              	unique              	edinstven
namera              	intention           	intention           	namera
škola               	school              	school              	škola
posledica           	consequence         	consequence         	posledica
manastir            	monastery           	monastery           	manastir
sličen              	similar             	similar             	sličen
nezavisnost         	independence        	independence        	nezavisnost
fizika              	physics             	physics             	fizika
kombinacija         	combination         	combination         	kombinacija
proizvod            	product             	product             	proizvod
govor               	speech              	speech              	govor
teren               	terrain             	terrain             	teren
bitka               	battle              	battle              	bitka
spreči              	prevent             	prevent             	spreči
oprema              	equipment           	equipment           	oprema
baza                	base                	base                	baza
pad                 	fall                	fall                	pad
akcija              	action              	action              	akcija
reakcija            	reaction            	reaction            	reakcija
kanal               	channel             	channel             	kanal
nacionalen          	national            	national            	nacionalen
planinski           	mountainous         	mountainous         	planinski
element             	element             	element             	element
vesnik              	newspaper           	newspaper           	vesnik
gas                 	gas                 	gas                 	gas
klima               	air conditioning    	air conditioning    	klima
filmski             	cinematic           	cinematic           	filmski
tehnika             	technique           	technique           	tehnika
javno               	publicly            	publicly            	javno
sposobnost          	ability             	ability             	sposobnost
trgovski            	commercial          	commercial          	trgovski
kontakt             	contact             	contact             	kontakt
institut            	institute           	institute           	institut
nasilstvo           	violence            	violence            	nasilstvo
brod                	ship                	ship                	brod
popis               	inventory           	inventory           	popis
prevod              	translation         	translation         	prevod
živ                 	alive               	alive               	živ
korist              	benefit             	benefit             	korist
dokaz               	proof               	proof               	dokaz
poraz               	defeat              	defeat              	poraz
različen            	different           	different           	različen
silen               	strong              	strong              	silen
formiranje          	formation           	formation           	formiranje
južno               	south               	south               	južno
gora                	mountain            	mountain            	gora
komunikacija        	communication       	communication       	komunikacija
generacija          	generation          	generation          	generacija
vino                	wine                	wine                	vino
biblioteka          	library             	library             	biblioteka
napraven            	made                	made                	napraven
populacija          	population          	population          	populacija
porast              	increase            	increase            	porast
mlad                	young               	young               	mlad
sam                 	alone               	alone               	sam
filozofija          	philosophy          	philosophy          	filozofija
mislenje            	thinking            	thinking            	mislenje
količina            	quantity            	quantity            	količina
termin              	term                	term                	termin
meso                	meat                	meat                	meso
odgovoren           	responsible         	responsible         	odgovoren
aktiven             	active              	active              	aktiven
sala                	hall                	hall                	sala
religija            	religion            	religion            	religija
turnir              	tournament          	tournament          	turnir
televizija          	television          	television          	televizija
epizoda             	episode             	episode             	epizoda
par                 	couple              	couple              	par
